9 7 7 7 7 7 7 7 7 7 7 7 7 7 7 9
8 2 6 6 6 6 6 6 6 6 6 6 6 6 1 7
8 0 0 0 0 0 0 0 0 0 0 0 0 0 0 7
8 0 0 0 0 0 0 0 0 0 0 0 0 0 0 7
8 0 0 0 0 0 7 7 7 7 0 0 0 0 0 7
0 0 0 0 0 0 7 9 9 7 0 0 0 0 0 7
0 0 0 0 0 0 7 9 9 7 0 0 0 0 0 7
0 0 0 0 0 0 7 7 7 7 0 0 0 0 0 7
8 0 0 0 0 0 0 0 0 0 0 0 0 0 0 7
8 0 0 0 0 0 0 0 0 0 0 0 0 0 0 7
8 5 5 5 5 5 5 5 5 5 5 5 5 5 5 7
9 7 7 7 7 7 7 7 7 7 7 7 7 7 7 9