7 7 7 7 7 7 7 7 7 7 7 7 7 7 7 7 7 7 7 7 7 7 7 7 7 7 7 7 7 7 7 7 7 7 7 7 7 7 7 7 7 7 7 8
8 7 7 7 7 7 7 7 7 7 7 7 7 7 7 7 7 7 7 7 7 7 7 7 7 7 7 7 7 7 7 7 7 7 7 7 7 7 7 7 7 7 7 8
8 7 7 7 7 7 7 7 7 7 7 7 7 7 7 7 7 7 7 7 7 7 7 7 7 7 7 7 7 7 7 7 7 7 7 7 7 7 7 7 7 7 7 8
8 7 7 7 7 7 7 7 7 7 7 7 7 7 7 7 7 7 7 7 7 7 7 7 7 7 7 7 7 7 7 7 7 7 7 7 7 7 7 7 7 7 7 8
8 8 9 9 9 9 9 9 9 7 7 7 7 7 7 9 9 9 9 9 9 9 9 9 9 9 9 9 9 9 9 9 9 9 9 9 9 9 9 9 9 9 8 8
8 8 9 9 9 9 9 0 0 0 0 0 0 0 9 9 9 9 9 9 9 9 9 9 9 9 9 9 9 9 0 0 0 0 0 9 0 0 0 9 9 9 8 8
8 8 9 9 9 9 9 0 0 0 0 0 0 0 0 0 0 0 0 9 9 9 9 9 9 9 9 9 9 9 0 0 0 9 0 0 0 0 0 9 9 9 8 8
8 8 9 9 9 2 0 0 0 0 9 9 9 9 9 9 9 9 0 9 9 9 9 9 9 9 9 9 9 9 9 9 9 9 0 9 9 9 9 9 9 9 8 8
8 8 9 9 9 0 0 0 0 0 9 6 6 6 6 6 6 6 0 6 6 0 0 0 9 0 0 0 0 0 0 0 0 0 0 0 0 9 9 9 9 9 8 8
8 8 9 9 9 0 0 0 0 0 9 0 0 0 0 0 0 0 0 0 0 0 0 0 9 0 0 9 9 9 0 0 0 0 0 0 0 9 9 9 9 9 8 8
8 8 9 9 9 0 0 0 0 0 9 0 0 0 0 0 0 0 0 0 0 0 0 0 9 0 0 9 9 9 0 0 0 0 0 0 0 9 9 9 9 9 8 8
8 8 9 9 9 9 9 0 9 9 9 0 9 9 9 9 0 0 9 0 0 9 0 0 9 0 0 0 0 0 0 0 9 9 9 0 0 9 9 9 9 9 8 8
8 8 9 9 9 9 9 0 0 0 0 0 0 0 0 0 0 0 9 0 0 9 0 0 9 0 0 0 0 0 0 0 0 0 0 0 0 9 9 9 9 9 8 8
8 8 9 9 9 9 9 0 0 0 0 0 0 0 0 0 0 0 9 0 0 9 0 0 9 0 0 0 7 7 8 0 0 0 0 0 0 0 0 0 9 9 8 8
8 8 9 9 9 9 9 0 0 0 0 0 9 9 9 9 0 0 9 0 0 9 0 0 0 0 0 0 8 7 8 0 0 0 0 0 0 0 0 0 9 9 8 8
8 8 9 9 9 9 9 0 0 0 0 0 0 0 0 0 0 0 0 0 0 0 0 0 0 0 0 0 8 7 8 0 9 9 9 0 0 9 9 9 9 9 8 8
8 8 9 9 9 9 9 0 0 0 0 9 0 0 0 0 0 0 0 0 0 0 0 0 0 0 0 0 8 7 8 0 9 9 9 0 0 9 9 9 9 9 8 8
8 8 0 0 0 0 0 0 0 0 0 9 5 5 0 5 5 5 5 5 5 9 0 0 9 0 0 0 0 0 0 0 0 0 0 0 0 0 0 9 9 9 8 8
8 8 0 0 0 0 0 0 0 0 0 9 9 9 0 9 9 9 9 9 9 9 0 0 9 9 9 9 9 0 0 0 9 9 9 9 9 9 0 9 9 9 8 8
8 8 0 0 0 0 0 0 0 0 0 9 9 9 0 9 9 9 9 9 9 9 0 0 9 9 9 9 9 0 0 0 9 9 9 9 9 9 0 9 9 9 8 8
8 8 5 5 5 5 5 0 0 5 0 0 0 0 0 9 9 9 9 0 0 0 0 0 0 0 0 0 0 0 0 0 0 0 9 9 9 9 0 9 9 9 8 8
8 8 9 9 9 9 9 0 0 9 9 8 9 9 0 9 9 9 9 0 0 0 0 0 0 0 0 0 0 0 0 0 0 0 0 0 0 0 0 9 9 9 8 8
8 8 9 9 9 9 9 0 0 9 9 8 9 9 0 9 9 9 9 0 0 0 0 0 0 0 0 0 0 0 0 0 0 0 9 9 0 9 9 9 9 9 8 8
8 8 9 9 9 9 9 0 0 0 0 0 0 0 0 9 9 9 9 9 0 0 9 9 9 9 9 9 0 0 9 9 9 0 9 9 0 9 9 9 9 9 8 8
8 8 9 9 9 9 9 9 9 9 9 9 9 0 0 9 9 9 9 9 0 0 9 9 9 9 9 9 9 9 9 9 9 0 9 9 0 9 9 9 9 9 8 8
8 8 9 9 9 9 9 9 9 9 9 9 9 0 0 0 0 0 0 0 0 0 9 9 9 9 9 9 9 9 9 9 9 0 0 0 0 9 9 9 9 9 8 8
8 8 9 9 9 9 9 9 9 9 9 9 9 9 9 9 9 9 9 9 9 9 9 9 9 9 9 9 9 9 9 9 9 9 9 9 9 9 9 9 9 9 8 8
8 8 9 9 9 9 9 9 9 9 9 9 9 9 9 9 9 9 9 9 9 9 9 9 9 9 9 9 9 9 9 9 9 9 9 9 9 9 9 9 9 9 8 8
8 8 9 9 9 9 9 9 9 9 9 9 9 9 9 9 9 9 9 9 9 9 9 9 9 9 9 9 9 9 9 9 9 9 9 9 9 9 9 9 9 9 8 8
9 9 9 9 9 9 9 9 9 9 9 9 9 9 9 9 9 9 9 9 9 9 9 9 9 9 9 9 9 9 9 9 9 9 9 9 9 9 9 9 9 9 9 8